GGGGGGTGGGGGGGGGGGGGGGGGGGGGGGGTGGGGGGG
SSSSSSRSSSSSSSSSSSSSSSSSSSSSSSSRSSSSSSS
GGGGGGTGGGGGGGGGGGGGGGGGGGGGGGGTGGGGGGG
GGGGGGTGGGGGGGGHGGGGGGGGGGGGGGGTGGGGGGG
GGGGGHTGGGGGGGGGGGGGGGGGGGGGGGGTGGGGGGG
GGGGGGTGGGGGGGGGGGGGGGGGGGGGGGGTGGGGGGG
GGGGGGTGGGGGGGGGGGGGGGGGGGGGGGGTGGGGGGG
GGGGGGTGGGGGGGGGGGGGGGGGGGGGGGGTGGGGGGG
GGGGGGTGGGGHHGGGGGGGGGGGGGGGGGGTGGGGGGG
GGGGGGTGHGGGGGGGGGGGGGGGGGGGGGGTGGGGGGG
GGGGGGTGGGGGGGGGWGGGGGGGGGGGGGGTGGGGGGG
GGGGGGTGGGGGGGGWWWGGGGGGGGGGGGGTGGGGGGG
GGGGGGTGGGGGGWWWWGGGGGGGGGGGGGGTGGGGGGG
GGGGGGTGGGGGGGGGGGGGGGGGGGGGGGGTGGGGGGG
GGGGGGTGGGGGGGGGGGHGGGGGGGGGGGGTGGGGGGG
GGGGGGTGGHGGHHHGGGGGGGGGGGGGGGGTGGGGGGG
GGGGGGTGGGGGGGGGGGGGGGGGGGGGGGGTGGGGGGG
GGGGGGTGGGHGGGGGGGGGGGGGGGGGGGGTGGGGGGG
GGGGGGTGGGGGGGGGGGGHGGGGGGGGGGGTGGGGGGG
